19
10
wwwwwwwwwwwwwwwwwww
w      w    w     w
w                 w
w                 w
w    w      w     w
w                 w
w   w   w   w     w
w           w     w
w    b            w
wwwwwwwwwwwwwwwwwww

